 ___________________
|  _   _ _       _  |
|  _|_ _  | |_|   | |
| |  _    | |   | | |
|_|_ _|_|_| |_| | | |
|    _ _ _   _|_|_| |
| |_|    _      |_  |
|_|  _|  _|_| |_ _| |
|  _  |_|_   _  |_ _|
| |_   _|    _|    _|
|_|_ _ _|_|_ _|_|_ _|
